####################################################
...................................................#
...................................................#
...................................................#
...................................................#
...................................................#
...@...............................................#
####################################################